0 0 0 0 0 0 0 0 0 0
0 0 0 0 0 0 0 0 0 0
0 0 0 0 0 4 4 4 0 0
0 0 0 0 0 0 0 0 0 0
0 0 0 0 0 0 0 0 0 5
3 3 3 3 3 3 3 3 3 3
2 2 2 2 2 2 2 2 2 2  
2 2 2 2 2 2 2 2 2 2 
